21 21 21 21 21 21 21 21 21 21 21 21 21 21 21 01 01 21 21 21 21 21 21 21 21 21 21 21 21 21 21 21 21 21 21 21 21 21 21 21 21 21 21 21 21 21 21 01 01 21 21 21 21 21 21 21 21 21 21 21 21 21 21 21 21 21 21 21 21 21 21 21 21 21 21 21 21 21 21 01 01 21 21 21 21 21 21 21 21 21 21 21 21 21 21 21
21 20 20 20 20 20 20 20 20 20 20 20 20 20 20 01 01 20 20 20 20 20 20 20 20 20 20 20 20 20 20 21 21 20 20 20 20 20 20 20 20 20 20 20 20 20 20 01 01 20 20 20 20 20 20 20 20 20 20 20 20 20 20 21 21 20 20 20 20 20 20 20 20 20 20 20 20 20 20 01 01 20 20 20 20 20 20 20 20 20 20 20 20 20 20 21
21 20 20 20 20 20 20 20 20 20 20 20 20 20 20 01 01 20 20 20 20 20 20 20 20 20 20 20 20 20 20 21 21 20 20 20 20 20 20 20 20 20 20 20 20 20 20 01 01 20 20 20 20 20 20 20 20 20 20 20 20 20 20 21 21 20 20 20 20 20 20 20 20 20 20 20 20 20 20 01 01 20 20 20 20 20 20 20 20 20 20 20 20 20 20 21
21 20 20 20 20 20 20 20 20 20 20 20 20 20 20 01 01 20 20 20 20 20 20 20 20 20 20 20 20 20 20 21 21 20 20 20 20 20 20 20 20 20 20 20 20 20 20 01 01 20 20 20 20 20 20 20 20 20 20 20 20 20 20 21 21 20 20 20 20 20 20 20 20 20 20 20 20 20 20 01 01 20 20 20 20 20 20 20 20 20 20 20 20 20 20 21
21 20 20 20 20 20 20 20 20 20 20 20 20 20 20 01 01 20 20 20 20 20 20 20 20 20 20 20 20 20 20 21 21 20 20 20 20 20 20 20 20 20 20 20 20 20 20 01 01 20 20 20 20 20 20 20 20 20 20 20 20 20 20 21 21 20 20 20 20 20 20 20 20 20 20 20 20 20 20 01 01 20 20 20 20 20 20 20 20 20 20 20 20 20 20 21
21 20 20 20 20 20 20 20 20 20 20 20 20 20 20 01 01 20 20 20 20 20 20 20 20 20 20 20 20 20 20 21 21 20 20 20 20 20 20 20 20 20 20 20 20 20 20 01 01 20 20 20 20 20 20 20 20 20 20 20 20 20 20 21 21 20 20 20 20 20 20 20 20 20 20 20 20 20 20 01 01 20 20 20 20 20 20 20 20 20 20 20 20 20 20 21
21 20 20 20 20 20 20 20 20 20 20 20 20 20 20 01 01 20 20 20 20 20 20 20 20 20 20 20 20 20 20 21 21 20 20 20 20 20 20 20 20 20 20 20 20 20 20 01 01 20 20 20 20 20 20 20 20 20 20 20 20 20 20 21 21 20 20 20 20 20 20 20 20 20 20 20 20 20 20 01 01 20 20 20 20 20 20 20 20 20 20 20 20 20 20 21
21 20 20 20 20 20 20 20 20 20 20 20 20 20 20 01 01 20 20 20 20 20 20 20 20 20 20 20 20 20 20 21 21 20 20 20 20 20 20 20 20 20 20 20 20 20 20 01 01 20 20 20 20 20 20 20 20 20 20 20 20 20 20 21 21 20 20 20 20 20 20 20 20 20 20 20 20 20 20 01 01 20 20 20 20 20 20 20 20 20 20 20 20 20 20 21
21 20 20 20 20 20 20 20 20 20 20 20 20 20 20 01 01 20 20 20 20 20 20 20 20 20 20 20 20 20 20 21 21 20 20 20 20 20 20 20 20 20 20 20 20 20 20 01 01 20 20 20 20 20 20 20 20 20 20 20 20 20 20 21 21 20 20 20 20 20 20 20 20 20 20 20 20 20 20 01 01 20 20 20 20 20 20 20 20 20 20 20 20 20 20 21
21 20 20 20 20 20 20 20 20 20 20 20 20 20 20 01 01 20 20 20 20 20 20 20 20 20 20 20 20 20 20 21 21 20 20 20 20 20 20 20 20 20 20 20 20 20 20 01 01 20 20 20 20 20 20 20 20 20 20 20 20 20 20 21 21 20 20 20 20 20 20 20 20 20 20 20 20 20 20 01 01 20 20 20 20 20 20 20 20 20 20 20 20 20 20 21
21 20 20 20 20 20 20 20 20 20 20 20 20 20 20 01 01 20 20 20 20 20 20 20 20 20 20 20 20 20 20 21 21 20 20 20 20 20 20 20 20 20 20 20 20 20 20 01 01 20 20 20 20 20 20 20 20 20 20 20 20 20 20 21 21 20 20 20 20 20 20 20 20 20 20 20 20 20 20 01 01 20 20 20 20 20 20 20 20 20 20 20 20 20 20 21
01 01 01 01 01 01 01 01 01 01 01 01 01 01 01 01 01 01 01 01 01 01 01 01 01 01 01 01 01 01 01 01 01 01 01 01 01 01 01 01 01 01 01 01 01 01 01 01 01 01 01 01 01 01 01 01 01 01 01 01 01 01 01 01 01 01 01 01 01 01 01 01 01 01 01 01 01 01 01 01 01 01 01 01 01 01 01 01 01 01 01 01 01 01 01 01
01 01 01 01 01 01 01 01 01 01 01 01 01 01 01 01 01 01 01 01 01 01 01 01 01 01 01 01 01 01 01 01 01 01 01 01 01 01 01 01 01 01 01 01 01 01 01 01 01 01 01 01 01 01 01 01 01 01 01 01 01 01 01 01 01 01 01 01 01 01 01 01 01 01 01 01 01 01 01 01 01 01 01 01 01 01 01 01 01 01 01 01 01 01 01 01
21 20 20 20 20 20 20 20 20 20 20 20 20 20 20 01 01 20 20 20 20 20 20 20 20 20 20 20 20 20 20 21 21 20 20 20 20 20 20 20 20 20 20 20 20 20 20 01 01 20 20 20 20 20 20 20 20 20 20 20 20 20 20 21 21 20 20 20 20 20 20 20 20 20 20 20 20 20 20 01 01 20 20 20 20 20 20 20 20 20 20 20 20 20 20 21
21 20 20 20 20 20 20 20 20 20 20 20 20 20 20 01 01 20 20 20 20 20 20 20 20 20 20 20 20 20 20 21 21 20 20 20 20 20 20 20 20 20 20 20 20 20 20 01 01 20 20 20 20 20 20 20 20 20 20 20 20 20 20 21 21 20 20 20 20 20 20 20 20 20 20 20 20 20 20 01 01 20 20 20 20 20 20 20 20 20 20 20 20 20 20 21
21 20 20 20 20 20 20 20 20 20 20 20 20 20 20 01 01 20 20 20 20 20 20 20 20 20 20 20 20 20 20 21 21 20 20 20 20 20 20 20 20 20 20 20 20 20 20 01 01 20 20 20 20 20 20 20 20 20 20 20 20 20 20 21 21 20 20 20 20 20 20 20 20 20 20 20 20 20 20 01 01 20 20 20 20 20 20 20 20 20 20 20 20 20 20 21
21 20 20 20 20 20 20 20 20 20 20 20 20 20 20 01 01 20 20 20 20 20 20 20 20 20 20 20 20 20 20 21 21 20 20 20 20 20 20 20 20 20 20 20 20 20 20 01 01 20 20 20 20 20 20 20 20 20 20 20 20 20 20 21 21 20 20 20 20 20 20 20 20 20 20 20 20 20 20 01 01 20 20 20 20 20 20 20 20 20 20 20 20 20 20 21
21 20 20 20 20 20 20 20 20 20 20 20 20 20 20 01 01 20 20 20 20 20 20 20 20 20 20 20 20 20 20 21 21 20 20 20 20 20 20 20 20 20 20 20 20 20 20 01 01 20 20 20 20 20 20 20 20 20 20 20 20 20 20 21 21 20 20 20 20 20 20 20 20 20 20 20 20 20 20 01 01 20 20 20 20 20 20 20 20 20 20 20 20 20 20 21
21 20 20 20 20 20 20 20 20 20 20 20 20 20 20 01 01 20 20 20 20 20 20 20 20 20 20 20 20 20 20 21 21 20 20 20 20 20 20 20 20 20 20 20 20 20 20 01 01 20 20 20 20 20 20 20 20 20 20 20 20 20 20 21 21 20 20 20 20 20 20 20 20 20 20 20 20 20 20 01 01 20 20 20 20 20 20 20 20 20 20 20 20 20 20 21
21 20 20 20 20 20 20 20 20 20 20 20 20 20 20 01 01 20 20 20 20 20 20 20 20 20 20 20 20 20 20 21 21 20 20 20 20 20 20 20 20 20 20 20 20 20 20 01 01 20 20 20 20 20 20 20 20 20 20 20 20 20 20 21 21 20 20 20 20 20 20 20 20 20 20 20 20 20 20 01 01 20 20 20 20 20 20 20 20 20 20 20 20 20 20 21
21 20 20 20 20 20 20 20 20 20 20 20 20 20 20 01 01 20 20 20 20 20 20 20 20 20 20 20 20 20 20 21 21 20 20 20 20 20 20 20 20 20 20 20 20 20 20 01 01 20 20 20 20 20 20 20 20 20 20 20 20 20 20 21 21 20 20 20 20 20 20 20 20 20 20 20 20 20 20 01 01 20 20 20 20 20 20 20 20 20 20 20 20 20 20 21
21 20 20 20 20 20 20 20 20 20 20 20 20 20 20 01 01 20 20 20 20 20 20 20 20 20 20 20 20 20 20 21 21 20 20 20 20 20 20 20 20 20 20 20 20 20 20 01 01 20 20 20 20 20 20 20 20 20 20 20 20 20 20 21 21 20 20 20 20 20 20 20 20 20 20 20 20 20 20 01 01 20 20 20 20 20 20 20 20 20 20 20 20 20 20 21
21 20 20 20 20 20 20 20 20 20 20 20 20 20 20 01 01 20 20 20 20 20 20 20 20 20 20 20 20 20 20 21 21 20 20 20 20 20 20 20 20 20 20 20 20 20 20 01 01 20 20 20 20 20 20 20 20 20 20 20 20 20 20 21 21 20 20 20 20 20 20 20 20 20 20 20 20 20 20 01 01 20 20 20 20 20 20 20 20 20 20 20 20 20 20 21
21 21 21 21 21 21 21 21 21 21 21 21 21 21 21 01 01 21 21 21 21 21 21 21 21 21 21 21 21 21 21 21 21 21 21 21 21 21 21 21 21 21 21 21 21 21 21 01 01 21 21 21 21 21 21 21 21 21 21 21 21 21 21 21 21 21 21 21 21 21 21 21 21 21 21 21 21 21 21 01 01 21 21 21 21 21 21 21 21 21 21 21 21 21 21 21
21 21 21 21 21 21 21 21 21 21 21 21 21 21 21 01 01 21 21 21 21 21 21 21 21 21 21 21 21 21 21 21 21 21 21 21 21 21 21 21 21 21 21 21 21 21 21 01 01 21 21 21 21 21 21 21 21 21 21 21 21 21 21 21 21 21 21 21 21 21 21 21 21 21 21 21 21 21 21 01 01 21 21 21 21 21 21 21 21 21 21 21 21 21 21 21
21 20 20 20 20 20 20 20 20 20 20 20 20 20 20 01 01 20 20 20 20 20 20 20 20 20 20 20 20 20 20 21 21 20 20 20 20 20 20 20 20 20 20 20 20 20 20 01 01 20 20 20 20 20 20 20 20 20 20 20 20 20 20 21 21 20 20 20 20 20 20 20 20 20 20 20 20 20 20 01 01 20 20 20 20 20 20 20 20 20 20 20 20 20 20 21
21 20 20 20 20 20 20 20 20 20 20 20 20 20 20 01 01 20 20 20 20 20 20 20 20 20 20 20 20 20 20 21 21 20 20 20 20 20 20 20 20 20 20 20 20 20 20 01 01 20 20 20 20 20 20 20 20 20 20 20 20 20 20 21 21 20 20 20 20 20 20 20 20 20 20 20 20 20 20 01 01 20 20 20 20 20 20 20 20 20 20 20 20 20 20 21
21 20 20 20 20 20 20 20 20 20 20 20 20 20 20 01 01 20 20 20 20 20 20 20 20 20 20 20 20 20 20 21 21 20 20 20 20 20 20 20 20 20 20 20 20 20 20 01 01 20 20 20 20 20 20 20 20 20 20 20 20 20 20 21 21 20 20 20 20 20 20 20 20 20 20 20 20 20 20 01 01 20 20 20 20 20 20 20 20 20 20 20 20 20 20 21
21 20 20 20 20 20 20 20 20 20 20 20 20 20 20 01 01 20 20 20 20 20 20 20 20 20 20 20 20 20 20 21 21 20 20 20 20 20 20 20 20 20 20 20 20 20 20 01 01 20 20 20 20 20 20 20 20 20 20 20 20 20 20 21 21 20 20 20 20 20 20 20 20 20 20 20 20 20 20 01 01 20 20 20 20 20 20 20 20 20 20 20 20 20 20 21
21 20 20 20 20 20 20 20 20 20 20 20 20 20 20 01 01 20 20 20 20 20 20 20 20 20 20 20 20 20 20 21 21 20 20 20 20 20 20 20 20 20 20 20 20 20 20 01 01 20 20 20 20 20 20 20 20 20 20 20 20 20 20 21 21 20 20 20 20 20 20 20 20 20 20 20 20 20 20 01 01 20 20 20 20 20 20 20 20 20 20 20 20 20 20 21
21 20 20 20 20 20 20 20 20 20 20 20 20 20 20 01 01 20 20 20 20 20 20 20 20 20 20 20 20 20 20 21 21 20 20 20 20 20 20 20 20 20 20 20 20 20 20 01 01 20 20 20 20 20 20 20 20 20 20 20 20 20 20 21 21 20 20 20 20 20 20 20 20 20 20 20 20 20 20 01 01 20 20 20 20 20 20 20 20 20 20 20 20 20 20 21
21 20 20 20 20 20 20 20 20 20 20 20 20 20 20 01 01 20 20 20 20 20 20 20 20 20 20 20 20 20 20 21 21 20 20 20 20 20 20 20 20 20 20 20 20 20 20 01 01 20 20 20 20 20 20 20 20 20 20 20 20 20 20 21 21 20 20 20 20 20 20 20 20 20 20 20 20 20 20 01 01 20 20 20 20 20 20 20 20 20 20 20 20 20 20 21
21 20 20 20 20 20 20 20 20 20 20 20 20 20 20 01 01 20 20 20 20 20 20 20 20 20 20 20 20 20 20 21 21 20 20 20 20 20 20 20 20 20 20 20 20 20 20 01 01 20 20 20 20 20 20 20 20 20 20 20 20 20 20 21 21 20 20 20 20 20 20 20 20 20 20 20 20 20 20 01 01 20 20 20 20 20 20 20 20 20 20 20 20 20 20 21
21 20 20 20 20 20 20 20 20 20 20 20 20 20 20 01 01 20 20 20 20 20 20 20 20 20 20 20 20 20 20 21 21 20 20 20 20 20 20 20 20 20 20 20 20 20 20 01 01 20 20 20 20 20 20 20 20 20 20 20 20 20 20 21 21 20 20 20 20 20 20 20 20 20 20 20 20 20 20 01 01 20 20 20 20 20 20 20 20 20 20 20 20 20 20 21
21 20 20 20 20 20 20 20 20 20 20 20 20 20 20 01 01 20 20 20 20 20 20 20 20 20 20 20 20 20 20 21 21 20 20 20 20 20 20 20 20 20 20 20 20 20 20 01 01 20 20 20 20 20 20 20 20 20 20 20 20 20 20 21 21 20 20 20 20 20 20 20 20 20 20 20 20 20 20 01 01 20 20 20 20 20 20 20 20 20 20 20 20 20 20 21
01 01 01 01 01 01 01 01 01 01 01 01 01 01 01 01 01 01 01 01 01 01 01 01 01 01 01 01 01 01 01 01 01 01 01 01 01 01 01 01 01 01 01 01 01 01 01 01 01 01 01 01 01 01 01 01 01 01 01 01 01 01 01 01 01 01 01 01 01 01 01 01 01 01 01 01 01 01 01 01 01 01 01 01 01 01 01 01 01 01 01 01 01 01 01 01
01 01 01 01 01 01 01 01 01 01 01 01 01 01 01 01 01 01 01 01 01 01 01 01 01 01 01 01 01 01 01 01 01 01 01 01 01 01 01 01 01 01 01 01 01 01 01 01 01 01 01 01 01 01 01 01 01 01 01 01 01 01 01 01 01 01 01 01 01 01 01 01 01 01 01 01 01 01 01 01 01 01 01 01 01 01 01 01 01 01 01 01 01 01 01 01
21 20 20 20 20 20 20 20 20 20 20 20 20 20 20 01 01 20 20 20 20 20 20 20 20 20 20 20 20 20 20 21 21 20 20 20 20 20 20 20 20 20 20 20 20 20 20 01 01 20 20 20 20 20 20 20 20 20 20 20 20 20 20 21 21 20 20 20 20 20 20 20 20 20 20 20 20 20 20 01 01 20 20 20 20 20 20 20 20 20 20 20 20 20 20 21
21 20 20 20 20 20 20 20 20 20 20 20 20 20 20 01 01 20 20 20 20 20 20 20 20 20 20 20 20 20 20 21 21 20 20 20 20 20 20 20 20 20 20 20 20 20 20 01 01 20 20 20 20 20 20 20 20 20 20 20 20 20 20 21 21 20 20 20 20 20 20 20 20 20 20 20 20 20 20 01 01 20 20 20 20 20 20 20 20 20 20 20 20 20 20 21
21 20 20 20 20 20 20 20 20 20 20 20 20 20 20 01 01 20 20 20 20 20 20 20 20 20 20 20 20 20 20 21 21 20 20 20 20 20 20 20 20 20 20 20 20 20 20 01 01 20 20 20 20 20 20 20 20 20 20 20 20 20 20 21 21 20 20 20 20 20 20 20 20 20 20 20 20 20 20 01 01 20 20 20 20 20 20 20 20 20 20 20 20 20 20 21
21 20 20 20 20 20 20 20 20 20 20 20 20 20 20 01 01 20 20 20 20 20 20 20 20 20 20 20 20 20 20 21 21 20 20 20 20 20 20 20 20 20 20 20 20 20 20 01 01 20 20 20 20 20 20 20 20 20 20 20 20 20 20 21 21 20 20 20 20 20 20 20 20 20 20 20 20 20 20 01 01 20 20 20 20 20 20 20 20 20 20 20 20 20 20 21
21 20 20 20 20 20 20 20 20 20 20 20 20 20 20 01 01 20 20 20 20 20 20 20 20 20 20 20 20 20 20 21 21 20 20 20 20 20 20 20 20 20 20 20 20 20 20 01 01 20 20 20 20 20 20 20 20 20 20 20 20 20 20 21 21 20 20 20 20 20 20 20 20 20 20 20 20 20 20 01 01 20 20 20 20 20 20 20 20 20 20 20 20 20 20 21
21 20 20 20 20 20 20 20 20 20 20 20 20 20 20 01 01 20 20 20 20 20 20 20 20 20 20 20 20 20 20 21 21 20 20 20 20 20 20 20 20 20 20 20 20 20 20 01 01 20 20 20 20 20 20 20 20 20 20 20 20 20 20 21 21 20 20 20 20 20 20 20 20 20 20 20 20 20 20 01 01 20 20 20 20 20 20 20 20 20 20 20 20 20 20 21
21 20 20 20 20 20 20 20 20 20 20 20 20 20 20 01 01 20 20 20 20 20 20 20 20 20 20 20 20 20 20 21 21 20 20 20 20 20 20 20 20 20 20 20 20 20 20 01 01 20 20 20 20 20 20 20 20 20 20 20 20 20 20 21 21 20 20 20 20 20 20 20 20 20 20 20 20 20 20 01 01 20 20 20 20 20 20 20 20 20 20 20 20 20 20 21
21 20 20 20 20 20 20 20 20 20 20 20 20 20 20 01 01 20 20 20 20 20 20 20 20 20 20 20 20 20 20 21 21 20 20 20 20 20 20 20 20 20 20 20 20 20 20 01 01 20 20 20 20 20 20 20 20 20 20 20 20 20 20 21 21 20 20 20 20 20 20 20 20 20 20 20 20 20 20 01 01 20 20 20 20 20 20 20 20 20 20 20 20 20 20 21
21 20 20 20 20 20 20 20 20 20 20 20 20 20 20 01 01 20 20 20 20 20 20 20 20 20 20 20 20 20 20 21 21 20 20 20 20 20 20 20 20 20 20 20 20 20 20 01 01 20 20 20 20 20 20 20 20 20 20 20 20 20 20 21 21 20 20 20 20 20 20 20 20 20 20 20 20 20 20 01 01 20 20 20 20 20 20 20 20 20 20 20 20 20 20 21
21 20 20 20 20 20 20 20 20 20 20 20 20 20 20 01 01 20 20 20 20 20 20 20 20 20 20 20 20 20 20 21 21 20 20 20 20 20 20 20 20 20 20 20 20 20 20 01 01 20 20 20 20 20 20 20 20 20 20 20 20 20 20 21 21 20 20 20 20 20 20 20 20 20 20 20 20 20 20 01 01 20 20 20 20 20 20 20 20 20 20 20 20 20 20 21
21 21 21 21 21 21 21 21 21 21 21 21 21 21 21 01 01 21 21 21 21 21 21 21 21 21 21 21 21 21 21 21 21 21 21 21 21 21 21 21 21 21 21 21 21 21 21 01 01 21 21 21 21 21 21 21 21 21 21 21 21 21 21 21 21 21 21 21 21 21 21 21 21 21 21 21 21 21 21 01 01 21 21 21 21 21 21 21 21 21 21 21 21 21 21 21
21 21 21 21 21 21 21 21 21 21 21 21 21 21 21 01 01 21 21 21 21 21 21 21 21 21 21 21 21 21 21 21 21 21 21 21 21 21 21 21 21 21 21 21 21 21 21 01 01 21 21 21 21 21 21 21 21 21 21 21 21 21 21 21 21 21 21 21 21 21 21 21 21 21 21 21 21 21 21 01 01 21 21 21 21 21 21 21 21 21 21 21 21 21 21 21
21 20 20 20 20 20 20 20 20 20 20 20 20 20 20 01 01 20 20 20 20 20 20 20 20 20 20 20 20 20 20 21 21 20 20 20 20 20 20 20 20 20 20 20 20 20 20 01 01 20 20 20 20 20 20 20 20 20 20 20 20 20 20 21 21 20 20 20 20 20 20 20 20 20 20 20 20 20 20 01 01 20 20 20 20 20 20 20 20 20 20 20 20 20 20 21
21 20 20 20 20 20 20 20 20 20 20 20 20 20 20 01 01 20 20 20 20 20 20 20 20 20 20 20 20 20 20 21 21 20 20 20 20 20 20 20 20 20 20 20 20 20 20 01 01 20 20 20 20 20 20 20 20 20 20 20 20 20 20 21 21 20 20 20 20 20 20 20 20 20 20 20 20 20 20 01 01 20 20 20 20 20 20 20 20 20 20 20 20 20 20 21
21 20 20 20 20 20 20 20 20 20 20 20 20 20 20 01 01 20 20 20 20 20 20 20 20 20 20 20 20 20 20 21 21 20 20 20 20 20 20 20 20 20 20 20 20 20 20 01 01 20 20 20 20 20 20 20 20 20 20 20 20 20 20 21 21 20 20 20 20 20 20 20 20 20 20 20 20 20 20 01 01 20 20 20 20 20 20 20 20 20 20 20 20 20 20 21
21 20 20 20 20 20 20 20 20 20 20 20 20 20 20 01 01 20 20 20 20 20 20 20 20 20 20 20 20 20 20 21 21 20 20 20 20 20 20 20 20 20 20 20 20 20 20 01 01 20 20 20 20 20 20 20 20 20 20 20 20 20 20 21 21 20 20 20 20 20 20 20 20 20 20 20 20 20 20 01 01 20 20 20 20 20 20 20 20 20 20 20 20 20 20 21
21 20 20 20 20 20 20 20 20 20 20 20 20 20 20 01 01 20 20 20 20 20 20 20 20 20 20 20 20 20 20 21 21 20 20 20 20 20 20 20 20 20 20 20 20 20 20 01 01 20 20 20 20 20 20 20 20 20 20 20 20 20 20 21 21 20 20 20 20 20 20 20 20 20 20 20 20 20 20 01 01 20 20 20 20 20 20 20 20 20 20 20 20 20 20 21
21 20 20 20 20 20 20 20 20 20 20 20 20 20 20 01 01 20 20 20 20 20 20 20 20 20 20 20 20 20 20 21 21 20 20 20 20 20 20 20 20 20 20 20 20 20 20 01 01 20 20 20 20 20 20 20 20 20 20 20 20 20 20 21 21 20 20 20 20 20 20 20 20 20 20 20 20 20 20 01 01 20 20 20 20 20 20 20 20 20 20 20 20 20 20 21
21 20 20 20 20 20 20 20 20 20 20 20 20 20 20 01 01 20 20 20 20 20 20 20 20 20 20 20 20 20 20 21 21 20 20 20 20 20 20 20 20 20 20 20 20 20 20 01 01 20 20 20 20 20 20 20 20 20 20 20 20 20 20 21 21 20 20 20 20 20 20 20 20 20 20 20 20 20 20 01 01 20 20 20 20 20 20 20 20 20 20 20 20 20 20 21
21 20 20 20 20 20 20 20 20 20 20 20 20 20 20 01 01 20 20 20 20 20 20 20 20 20 20 20 20 20 20 21 21 20 20 20 20 20 20 20 20 20 20 20 20 20 20 01 01 20 20 20 20 20 20 20 20 20 20 20 20 20 20 21 21 20 20 20 20 20 20 20 20 20 20 20 20 20 20 01 01 20 20 20 20 20 20 20 20 20 20 20 20 20 20 21
21 20 20 20 20 20 20 20 20 20 20 20 20 20 20 01 01 20 20 20 20 20 20 20 20 20 20 20 20 20 20 21 21 20 20 20 20 20 20 20 20 20 20 20 20 20 20 01 01 20 20 20 20 20 20 20 20 20 20 20 20 20 20 21 21 20 20 20 20 20 20 20 20 20 20 20 20 20 20 01 01 20 20 20 20 20 20 20 20 20 20 20 20 20 20 21
21 20 20 20 20 20 20 20 20 20 20 20 20 20 20 01 01 20 20 20 20 20 20 20 20 20 20 20 20 20 20 21 21 20 20 20 20 20 20 20 20 20 20 20 20 20 20 01 01 20 20 20 20 20 20 20 20 20 20 20 20 20 20 21 21 20 20 20 20 20 20 20 20 20 20 20 20 20 20 01 01 20 20 20 20 20 20 20 20 20 20 20 20 20 20 21
01 01 01 01 01 01 01 01 01 01 01 01 01 01 01 01 01 01 01 01 01 01 01 01 01 01 01 01 01 01 01 01 01 01 01 01 01 01 01 01 01 01 01 01 01 01 01 01 01 01 01 01 01 01 01 01 01 01 01 01 01 01 01 01 01 01 01 01 01 01 01 01 01 01 01 01 01 01 01 01 01 01 01 01 01 01 01 01 01 01 01 01 01 01 01 01
01 01 01 01 01 01 01 01 01 01 01 01 01 01 01 01 01 01 01 01 01 01 01 01 01 01 01 01 01 01 01 01 01 01 01 01 01 01 01 01 01 01 01 01 01 01 01 01 01 01 01 01 01 01 01 01 01 01 01 01 01 01 01 01 01 01 01 01 01 01 01 01 01 01 01 01 01 01 01 01 01 01 01 01 01 01 01 01 01 01 01 01 01 01 01 01
21 20 20 20 20 20 20 20 20 20 20 20 20 20 20 01 01 20 20 20 20 20 20 20 20 20 20 20 20 20 20 21 21 20 20 20 20 20 20 20 20 20 20 20 20 20 20 01 01 20 20 20 20 20 20 20 20 20 20 20 20 20 20 21 21 20 20 20 20 20 20 20 20 20 20 20 20 20 20 01 01 20 20 20 20 20 20 20 20 20 20 20 20 20 20 21
21 20 20 20 20 20 20 20 20 20 20 20 20 20 20 01 01 20 20 20 20 20 20 20 20 20 20 20 20 20 20 21 21 20 20 20 20 20 20 20 20 20 20 20 20 20 20 01 01 20 20 20 20 20 20 20 20 20 20 20 20 20 20 21 21 20 20 20 20 20 20 20 20 20 20 20 20 20 20 01 01 20 20 20 20 20 20 20 20 20 20 20 20 20 20 21
21 20 20 20 20 20 20 20 20 20 20 20 20 20 20 01 01 20 20 20 20 20 20 20 20 20 20 20 20 20 20 21 21 20 20 20 20 20 20 20 20 20 20 20 20 20 20 01 01 20 20 20 20 20 20 20 20 20 20 20 20 20 20 21 21 20 20 20 20 20 20 20 20 20 20 20 20 20 20 01 01 20 20 20 20 20 20 20 20 20 20 20 20 20 20 21
21 20 20 20 20 20 20 20 20 20 20 20 20 20 20 01 01 20 20 20 20 20 20 20 20 20 20 20 20 20 20 21 21 20 20 20 20 20 20 20 20 20 20 20 20 20 20 01 01 20 20 20 20 20 20 20 20 20 20 20 20 20 20 21 21 20 20 20 20 20 20 20 20 20 20 20 20 20 20 01 01 20 20 20 20 20 20 20 20 20 20 20 20 20 20 21
21 20 20 20 20 20 20 20 20 20 20 20 20 20 20 01 01 20 20 20 20 20 20 20 20 20 20 20 20 20 20 21 21 20 20 20 20 20 20 20 20 20 20 20 20 20 20 01 01 20 20 20 20 20 20 20 20 20 20 20 20 20 20 21 21 20 20 20 20 20 20 20 20 20 20 20 20 20 20 01 01 20 20 20 20 20 20 20 20 20 20 20 20 20 20 21
21 20 20 20 20 20 20 20 20 20 20 20 20 20 20 01 01 20 20 20 20 20 20 20 20 20 20 20 20 20 20 21 21 20 20 20 20 20 20 20 20 20 20 20 20 20 20 01 01 20 20 20 20 20 20 20 20 20 20 20 20 20 20 21 21 20 20 20 20 20 20 20 20 20 20 20 20 20 20 01 01 20 20 20 20 20 20 20 20 20 20 20 20 20 20 21
21 20 20 20 20 20 20 20 20 20 20 20 20 20 20 01 01 20 20 20 20 20 20 20 20 20 20 20 20 20 20 21 21 20 20 20 20 20 20 20 20 20 20 20 20 20 20 01 01 20 20 20 20 20 20 20 20 20 20 20 20 20 20 21 21 20 20 20 20 20 20 20 20 20 20 20 20 20 20 01 01 20 20 20 20 20 20 20 20 20 20 20 20 20 20 21
21 20 20 20 20 20 20 20 20 20 20 20 20 20 20 01 01 20 20 20 20 20 20 20 20 20 20 20 20 20 20 21 21 20 20 20 20 20 20 20 20 20 20 20 20 20 20 01 01 20 20 20 20 20 20 20 20 20 20 20 20 20 20 21 21 20 20 20 20 20 20 20 20 20 20 20 20 20 20 01 01 20 20 20 20 20 20 20 20 20 20 20 20 20 20 21
21 20 20 20 20 20 20 20 20 20 20 20 20 20 20 01 01 20 20 20 20 20 20 20 20 20 20 20 20 20 20 21 21 20 20 20 20 20 20 20 20 20 20 20 20 20 20 01 01 20 20 20 20 20 20 20 20 20 20 20 20 20 20 21 21 20 20 20 20 20 20 20 20 20 20 20 20 20 20 01 01 20 20 20 20 20 20 20 20 20 20 20 20 20 20 21
21 20 20 20 20 20 20 20 20 20 20 20 20 20 20 01 01 20 20 20 20 20 20 20 20 20 20 20 20 20 20 21 21 20 20 20 20 20 20 20 20 20 20 20 20 20 20 01 01 20 20 20 20 20 20 20 20 20 20 20 20 20 20 21 21 20 20 20 20 20 20 20 20 20 20 20 20 20 20 01 01 20 20 20 20 20 20 20 20 20 20 20 20 20 20 21
21 21 21 21 21 21 21 21 21 21 21 21 21 21 21 01 01 21 21 21 21 21 21 21 21 21 21 21 21 21 21 21 21 21 21 21 21 21 21 21 21 21 21 21 21 21 21 01 01 21 21 21 21 21 21 21 21 21 21 21 21 21 21 21 21 21 21 21 21 21 21 21 21 21 21 21 21 21 21 01 01 21 21 21 21 21 21 21 21 21 21 21 21 21 21 21